S##..###E.
....#.#...
##..#.###.
...#.##.#.
..#....##.
..#..#.#..
.#..#..#.#
.#...#.#..
.#.###.#..
...#......

