S..###.....
...###..#..
..#....##..
...#....#.#
..##....#..
...#....#..
........#E.


