###################
S.#.#.#.#.#.#.#.#.E
#.#.#.#.#.#.#.#.#.#
#.#.........#.#.#.#
#.#.#######.#.#.#.#
#.#.#...#.#.#...#.#
#.#.#.#.#.#.#.#.#.#
#...#.#.#.#.#.#.#.#
#.#.#.#.#.#.#...#.#
#.#.#.#.#.#.#####.#
#.#.#.#.#.#.......#
#.#...#.#.#.#.#.#.#
#.#.###.#.#.#.#.#.#
#...#...#.#.#...#.#
#.#.#.#####.#####.#
#.#.#.#...#.......#
#.#.#.#.#.#.#.#.#.#
#.#.#.#.#.#.#.#.#.#
###################
