S..###.....
....##..#..
..#....##..
...#....#.#
..##....#..
...#....#..
........#E.